111111111111111111111
100000100000000000001
100000100000000000001
100000000011111000001
100000000010000000001
100000100011111000001
100000100000000000001
111111111111111111111