NO assets/japan/north.xpm
SO assets/japan/south.xpm
WE assets/japan/west.xpm
EA 234,95,123

F 0,0,255
C 145,1,255

111111111111111111100
100000100000000000000
100000100000000000000
100000000011111000000
100000000011111000000
100000100000000000000
100000100000000000000
111111111111111111110