1111111
1000001
1000001
1101111
1001001
1001001
1000001
1111111